0000000000000000000000000000000000000000
0000000000000000000000000000000000000000
0000000000000000000000000000000000000000
0000000000000000000000000000000000000000
0000000000000000000000000000000000000000
0000000000000000000000000000000000000000
0000000000011110000000001110000000000000
0000001100000000000000000000000000000000
0000000000000000001110000000000000000000
0000000000000000000000000000000000000000
0000011111000000000000000000000111000000
0000000000000000000000000000000000000000
1100000000000000000000000000000000000011
1100000000000011111111111100000000000011
1111111111111111111111111111111111111111
1111111111111111111111111111111111111111
1111111111111111111111111111111111111111
1111111111111111111111111111111111111111
1111111111111111111111111111111111111111
1111111111111111111111111111111111111111